22222222222222222222
00000050000000005002
00000011105000000002
00500000000000050002
00000000000000000002
00000060000600002002
00000001100100000002
00060204210410600402
00010200220020100002
00000000000000000003
11111111111111111111