00000000000000000000
00000050000000000000
00000000050000030000
00500000000000011000
00000000006000022001
00600060011000022012
00100010022000022622
04200020422040111122
00200020022000222222
00000000000000000000
11111111111111111111