00000000000000000000
00005000000000005000
05000000000500000000
00000050000000000004
30000000600000050000
11000001106000040062
22100002211000000011
0004022222000110222
2222000000060220022
0000000000000000000
1111111111111111111